111111111111111111111111
1E0000000000000000011001
101001010000100000010101
101001001010101000010101
1P0000000000011100000001
111111111111111111111111