111111111111111111111111
1E0000000000C00100000001
101001010010000100010101
101001001010101000110101
100000000C00C000000000C1
111111111111111111111111