1111111111111111111111111111
1E001100C00C0000000000000001
100000C0000000000C000010C001
10000011P0000000000000000001
100C000000000C0000001000C001
100C00000C00000000000000C001
100C000000000C0000010000C001
100C0011000000000C000000C001
1111111111111111111111111111