1111111111111111111111111111
1000000C200P0000000000000001
100200000020000C000000000001
1000200000000000000000000001
1000000C00000000000C00000001
10000000C0002000000200002001
1002000000000000000000C00001
100000000200100000200C000001
10000000E00000000000C0000001
1000000C000000000E00000C0001
1000000000020002000000000001
1111111111111111111111111111