1111111111111111111
1E001100C00C0000001
120000000000010C001
100001111P000200001
120C00002000000C001
1111111111111111111